#####################################
#				#
#				#
#				#
#				#
#				#
#				#
#				#
#				#
#				#
#				#
#				#
#				#
#				#
#				#
#				#
#				#
#				#
#				#
#				#
#####################################